FI-00001|A12
FI-00002|B05
FI-00003|C10,D01
FI-00042|A02
FI-00009|A09
FI-00021|A05
